111111111111111111
1C001110000C000001
100001000111000001
1000000C0000000001
1000010000000000C1
1000000C0000C00001
100001000111000001
1000000C0000C00001
100001000111000001
100000000000000001
100000000000C00001
100P00101000000001
100000101000C00001
1C00001C100E000001
111111111111111111
