111111111111111111
1C001110000C000001
100001000111000001
1000000C0000000001
1000010000000010C1
1000000C0000C00001
100P0100011100E001
111111111111111111
